7 13
......#......
##.#######.#.
.#.........#.
.#.##..###.#.
...#.....#.#.
.#####.#.#.#.
....S..#..#E.